................................
................................
................................
................................
...#########################....
...#.......................#....
...#.......................#....
...#...##################..#....
...#...#................#..#....
...#...#...................#....
...#...#####################....
...#............................
...#............................
...#############################
................................
..............###...............
............1.#$#.2.............
..............###...............
