##########..####################
##.............................#
...............................#
#.........#####...#............#
#..#..#...#...#...#............#
#.....#...#...#...#............#
#.....#####...#####............#
#..............#...............#
#..............#...............#
#..............#...............#
#..............#...............#
#..............#...............#
#.............##...............#
#..............#...............#
#..............................#
#.............###..............#
#...........1.#$#.2............#
################################
