................................
................................
..########################..##..
..########################..##..
..##....................##..##..
..##....................##..##..
..##...###############..##..##..
..##...###############..##..##..
..##...##...............##..##..
..##...###################..##..
..##...###################..##..
..##........................##..
..############################..
..############################..
................................
..............###...............
............1.#$#.2.............
..............###...............