################################
#..............................#
...............................#
#.........#####...#............#
#.....#...#...#...#............#
#.....#...#...#...#............#
#.....#####...#####............#
#..............#...............#
#..............#...............#
#..............#...............#
#..............#...............#
#..............#...............#
#.............###..............#
#..............#...............#
#..............................#
#.............###..............#
#...........1.#$#.2............#
################################
