................................
.#..............................
................................
..........#####...#.............
...#..#...#...#...#.............
......#...#...#...#.............
......#####...#####.............
...............#................
...............#................
...............#................
...............#................
...............#................
..............##................
...............#................
................................
..............###...............
............1.#$#.2.............
................................
