................................
................................
...#...#...#...#...#...#...#....
...#...#...#...#...#...#...#....
...#...#...#...#...#...#...#....
...#...#...#...#...#...#...#....
...#...#...#...#...#...#...#....
...#...#...#...#...#...#...#....
...#...#...#...#...#...#...#....
...#...#...#...#...#...#...#....
...#...#...#...#...#...#...#....
...#...#...#...#...#...#...#....
...#...#...#...#...#...#...#....
................................
................................
..............###...............
............1.#$#.2.............
..............###...............
