................................
................................
..#..........................#..
...#........................#...
....#......................#....
.....#....................#.....
......#..................#......
.......#................#.......
........#..............#........
.........##############.........
........#..............#........
.......#................#.......
......#..................#.....
.....#....................#.....
....#......................#....
...#..........###...........#...
..#.........1.#$#.2..........#..
..............###...............
