................................
................................
..#...........#.#............#..
...#..........###...........#...
....#......#.......#.......#....
.....#.....#.......#......#.....
#.....#....#########.....#.....#
#......#................#......#
#.......#..............#.......#
#........##############........#
#.......#..............#.......#
#......#......###.......#......#
#.....#.......#.#........#.....#
.....#....................#.....
....#......................#....
...#..........###...........#...
..#.........1.#$#.2..........#..
..............###...............
