................................
...............#................
..#............#.............#..
...#...........#............#...
...............#................
.....#.........#..........#.....
......####################......
...............#................
...............#................
.........##############.........
...............#................
...............#................
......####################......
.....#....................#.....
................................
...#..........###...........#...
..#.........1.#$#.2..........#..
..............###...............
