................................
................................
.....#.....................#....
....###...................###...
.....#.....................#....
................................
...............#................
..............###...............
...............#................
................................
.....#.....................#....
....###...................###...
.....#.....................#....
................................
................................
..............###...............
............1.#$#.2.............
..............###...............
