................................
................................
.....#.........#...........#....
....###.......###.........###...
.....#.........#...........#....
................................
...............#................
#########.....###.....##########
...............#................
................................
.....#.........#...........#....
....###.......###.........###...
.....#.........#...........#....
................................
................................
#########.....###.....##########
............1.#$#.2.............
..............###...............
