................................
........#.#.........#.#.........
.........#.....#.....#..........
........#.#....#....#.#.........
...........#...#...#............
............#..#..#.............
..............###...............
.........######.######..........
..............###...............
............#..#..#.............
...........#...#...#............
........#.#....#....#.#.........
.........#.....#.....#..........
........#.#.........#.#.........
................................
..............###...............
............1.#$#.2.............
..............###...............
