................................
....................#......#....
#####################......#####
....................#......#....
....#......#....................
#####......#####################
....#......#....................
....................#......#....
#####################......#####
....................#......#....
....#......#....................
#####......#####################
....#......#....................
................................
................................
..............###...............
............1.#$#.2.............
..............###...............