................................
################################
################################
################################
################################
################################
################################
################################
################################
################################
################################
################################
################################
################################
############.........###########
############...###...###########
############.1.#$#.2.###########
############...###...###########