................................
................................
...#####..#####..#...#..#####...
...#......#...#..##.##..#.......
...#..##..#####..#.#.#..####....
...#...#..#...#..#...#..#.......
...#####..#...#..#...#..#####...
................................
...#####..#...#..#####..#####...
...#...#..#...#..#......#...#...
...#...#..#...#..####...#####...
...#...#...#.#...#......#..#....
...#####....#....#####..#...#...
................................
................................
................................
................................
................................
