................................
................................
........###.....................
........###.....................
........###.....................
........###.....................
........###.....................
........###.....................
........###.....................
........###.....................
........###.....................
........###.....................
........###.....................
........###.....................
........###.....................
........####################....
........####################....
................................