................................
................................
.......###......................
.......###......................
.......###......................
.......###......................
.......###......................
.......###......................
.......###......................
.......###......................
.......###......................
.......###......................
.......###......................
.......###......................
.......##################.......
.......##################.......
................................
................................