................................
................................
................................
..........############..........
........################........
.......#..############..#.......
........################........
...........##########...........
............########............
.............######.............
..............####..............
...............##...............
...............##...............
...............##...............
...............##...............
..........############..........
................................
................................