................................
................................
...###....................###...
...###....................###...
...###....................###...
...###....................###...
...###....................###...
...###....................###...
...###....................###...
...###........##..........###...
...###......######........###...
...###.....###..###.......###...
...###....###....###......###...
...###...###......###.....###...
...#########......###########...
...#########......###########...
................................
................................