................................
................................
...###....................###...
...###....................###...
...###....................###...
...###....................###...
...###....................###...
...###....................###...
...###.........##.........###...
...###........####........###...
...###.......######.......###...
....###.....###..###.....###....
.....###...###....###...###.....
......###.###......###.###......
.......#####........#####.......
.......#####........#####.......
................................
................................